Animate	            Animate	
no	                no	
yes	                yes	
Aspect	            Aspect	
perfective	        perfective	
progressive	        progressive	
CATEGORY	        Część mowy	
Adjective	        przymiotnik	
Conjunction	        spójnik	
Interjection	    wykrzyknik	
Numeral	            liczebnik	
Noun	            Rzeczownik	
Pronoun	            Zaimek
Particle	        imiesłów	
Adverb	            przysłówek	
Adposition	        przyimek	
Verb	            czasownik	
Case	            Przypadek	
accusative	        biernik
dative	            dative	
genitive	        genitive	
instrumental	    narzędnik	
locative	        locative	
nominative	        mianownik	
vocative	        vocative	
*n	                *n	
Case2	            Case2	
Coord_Type	        Coord_Type	
Definiteness	    Definiteness	
full-art	        full-art	
short-art	        short-art	
Degree	            Degree	
comparative	        comparative	
positive	        positive	
superlative	        superlative	
Form	            Form	
Formation	        Formation	
Gender	            rodzaj	
feminine	        żeński
masculine	        męski	
neuter	            nijaki	
common	            pospolity	
Number	            Liczba
singular	        pojedyńcza
plural	            mnoga	
Person	            Osoba	
first	            pierwsza
second	            druga	
third	            trzecia	
Sub_Type	        Sub_Type	
Syntactic_Type	    Syntactic_Type	
Tense	            Czas	
future	            przyszły
present	            teraźniejszy
past	            przeszły
Type	            Typ	
qualificative	    qualificative	
cardinal	        cardinal	
ordinal	            ordinal	
*p	                *p	
common	            pospolity	
proper	            proper	
p	                p	
main	            main	
VForm	            VForm	
gerund	            gerund	
indicative	        indicative	
imperative	        imperative	
infinitive	        infinitive	
participle	        participle	
Voice	            Voice	
active	            active	
medial	            medial	
passive	            passive	
